Datum;Uhrzeit;Todesfaelle;KH intensiv;KH nicht intensiv;Infziert ohne KH;Genesen;Gesamt;Quarantaene;Inzidenz
24.03.20;17:00;2;8;19;237;4;270;375;0
25.03.20;16:00;2;12;25;244;6;289;400;3,1
26.03.20;16:00;2;14;32;265;6;319;347;7,9
27.03.20;16:30;2;18;38;245;39;342;442;11,6
29.03.20;16:00;2;25;39;243;52;361;536;14,6
30.03.20;16:30;4;24;41;289;54;412;500;22,8
31.03.20;16:30;4;27;39;283;107;460;500;30,6
01.04.20;16:30;4;33;38;314;107;496;460;36,3
02.04.20;16:30;4;33;38;297;171;543;380;40,8
03.04.20;16:30;4;33;48;264;226;575;355;41,2
05.04.20;08:00;4;39;47;255;241;586;355;39,2
06.04.20;16:30;7;37;43;321;241;649;332;46,3
07.04.20;16:30;7;41;39;315;279;681;301;43,3
08.04.20;16:30;9;41;35;343;291;719;300;41,6
09.04.20;16:30;9;41;29;342;316;737;200;38,8
10.04.20;16:00;9;46;27;330;338;750;255;33,3
11.04.20;16:00;9;45;24;320;362;760;226;29,7
12.04.20;16:00;10;46;20;313;382;771;226;29,7
13.04.20;16:00;13;47;24;314;390;788;205;22,4
14.04.20;16:30;13;45;26;332;390;806;200;20,1
15.04.20;16:30;14;42;24;299;458;837;200;19
16.04.20;16:30;14;41;22;296;485;858;220;19,5
17.04.20;16:30;14;39;24;269;531;877;250;20,4
18.04.20;17:00;14;39;26;247;562;888;220;20,6
19.04.20;17:00;14;39;30;256;572;911;193;22,5
20.04.20;16:30;16;35;27;268;581;927;200;22,4
21.04.20;16:30;17;37;20;230;635;939;200;21,4
22.04.20;17:00;19;34;26;213;657;949;172;18
23.04.20;16:30;22;27;31;179;700;959;219;16,2
24.04.20;17:00;22;25;28;169;722;966;215;14,3
25.04.20;17:00;22;27;21;174;726;970;209;13,2
26.04.20;17:00;23;28;23;169;737;980;200;11,1
27.04.20;16:30;24;26;20;167;766;1003;200;12,2
28.04.20;17:00;24;25;23;179;766;1017;190;12,5
29.04.20;17:00;24;24;22;173;786;1029;190;12,9
30.04.20;17:00;24;20;20;169;817;1050;240;14,6
01.05.20;17:00;24;23;17;163;833;1060;235;15,1
02.05.20;17:00;24;22;20;156;852;1074;231;16,7
03.05.20;17:00;24;23;19;145;878;1089;240;17,5
04.05.20;17:00;24;21;17;142;885;1089;240;13,8
05.05.20;17:00;24;16;20;143;910;1113;232;15,4
06.05.20;17:00;25;18;19;172;913;1147;360;19
07.05.20;17:00;26;15;17;174;924;1156;308;17
08.05.20;17:00;27;15;22;167;933;1163;315;16,6
09.05.20;17:00;27;15;21;175;939;1177;324;16,6
10.05.20;17:00;27;15;20;179;943;1184;332;15,3
11.05.20;16:00;27;16;17;187;952;1199;330;17,7
12.05.20;16:00;28;15;16;171;974;1204;310;14,6
13.05.20;16:00;28;15;20;177;989;1229;322;13,2
14.05.20;16:00;28;13;23;188;999;1251;340;15,3
15.05.20;16:00;30;13;17;178;1021;1259;342;15,4
16.05.20;16:00;30;14;16;181;1028;1269;352;14,8
17.05.20;16:00;30;12;16;181;1039;1278;355;15,1
18.05.20;16:00;30;13;15;171;1054;1283;331;13,5
19.05.20;16:00;30;13;15;178;1056;1292;341;14,2
20.05.20;16:00;30;13;15;175;1081;1314;280;13,7
21.05.20;16:00;30;10;16;153;1115;1324;278;11,7
22.05.20;16:00;30;9;12;164;1124;1339;266;12,9
23.05.20;16:00;30;5;14;162;1130;1341;260;11,6
24.05.20;16:00;30;5;13;186;1142;1376;260;15,8
25.05.20;16:00;30;5;11;190;1148;1384;265;16,2
26.05.20;16:00;30;5;14;181;1164;1394;279;16,4
27.05.20;16:00;30;5;15;192;1169;1411;279;15,6
28.05.20;16:00;30;3;13;174;1200;1420;285;15,4
29.05.20;16:00;30;5;13;166;1216;1430;280;14,6
30.05.20;16:00;30;4;9;170;1227;1440;280;15,9
31.05.20;17:00;31;3;11;162;1237;1444;276;10,9
01.06.20;17:00;31;3;11;157;1246;1448;283;10,3
02.06.20;16:00;31;3;12;150;1252;1448;279;8,7
03.06.20;16:00;31;2;11;147;1265;1456;263;7,2
04.06.20;16:00;32;2;12;135;1285;1466;260;7,4
05.06.20;16:00;33;1;13;126;1306;1479;258;7,9
06.06.20;16:00;33;3;13;131;1308;1488;255;7,7
07.06.20;16:00;33;6;13;126;1310;1488;251;7,1
08.06.20;16:00;33;3;13;120;1327;1496;245;7,7
09.06.20;16:00;33;4;13;122;1350;1522;238;11,9
10.06.20;16:00;33;3;9;115;1364;1524;242;10,9
11.06.20;16:00;33;4;10;104;1380;1531;235;10,5
12.06.20;16:00;33;4;8;107;1386;1538;240;9,5
13.06.20;16:00;33;3;10;96;1396;1538;237;8
14.06.20;16:00;33;3;9;102;1405;1552;231;10,3
15.06.20;16:00;33;3;9;104;1410;1559;227;10,1
16.06.20;16:00;36;3;7;114;1410;1570;225;7,7
17.06.20;16:00;36;3;6;144;1410;1599;240;12,1
18.06.20;17:00;36;2;10;145;1421;1614;375;13,3
19.06.20;17:00;36;2;12;155;1429;1634;387;15,4
20.06.20;17:00;36;2;10;160;1442;1650;396;18
21.06.20;17:00;36;2;11;155;1451;1655;392;16,6
22.06.20;17:00;36;2;11;172;1451;1672;412;18,2
23.06.20;17:00;36;2;14;172;1459;1683;403;18,2
24.06.20;17:00;36;3;14;182;1486;1721;455;19,6
25.06.20;17:00;37;4;13;195;1488;1737;480;19,8
26.06.20;17:00;37;4;14;220;1494;1769;514;21,7
27.06.20;17:00;37;4;14;222;1501;1778;517;20,6
28.06.20;17:00;37;5;12;225;1508;1787;520;21,2
29.06.20;17:00;37;5;12;227;1515;1796;524;19,9
30.06.20;17:00;37;8;14;232;1522;1813;553;20,9
01.07.20;17:00;37;7;13;255;1542;1854;572;21,4
02.07.20;17:00;37;5;15;271;1561;1889;591;24,4
03.07.20;17:00;37;3;14;260;1598;1912;633;23
04.07.20;17:00;37;4;14;270;1598;1923;648;23,3
05.07.20;17:00;39;1;15;270;1611;1936;645;24
06.07.20;17:00;39;1;14;268;1616;1938;612;22,8
07.07.20;17:00;40;1;13;248;1651;1953;571;22,5
08.07.20;17:00;42;1;12;252;1654;1961;595;17,2
09.07.20;17:00;42;1;12;228;1681;1964;625;12,1
10.07.20;17:00;42;1;11;216;1699;1969;601;9,2
11.07.20;17:00;42;1;9;189;1728;1969;578;7,4
12.07.20;17:00;42;1;8;190;1732;1973;585;5,9
13.07.20;17:00;42;1;8;183;1742;1976;582;6,1
14.07.20;17:00;42;0;8;174;1755;1979;589;4,2
15.07.20;17:00;42;0;7;158;1776;1983;582;3,5
16.07.20;17:00;42;1;8;133;1814;1998;479;5,5
17.07.20;17:00;42;1;8;55;1899;2005;429;5,8
18.07.20;17:00;42;1;8;46;1910;2007;384;6,1
19.07.20;17:00;42;1;8;40;1923;2014;368;6,6
20.07.20;17:00;43;2;8;42;1924;2019;360;6,9
21.07.20;17:00;43;2;7;36;1939;2027;338;7,7
22.07.20;17:00;44;2;6;33;1951;2036;319;8,5
23.07.20;17:00;44;0;6;39;1955;2044;349;7,4
24.07.20;17:00;44;1;9;41;1958;2053;344;7,7
25.07.20;17:00;44;1;10;36;1974;2065;342;9,3
26.07.20;17:00;44;5;10;38;1974;2071;310;9,2
27.07.20;17:00;44;3;10;44;1976;2077;304;9,3
28.07.20;17:00;44;2;10;38;1988;2082;257;8,8
29.07.20;17:00;44;2;10;57;1995;2108;299;11,6
30.07.20;17:00;44;2;10;66;1998;2120;348;12,2
31.07.20;17:00;44;2;10;76;2014;2146;350;15
01.08.20;17:00;44;3;15;70;2029;2161;357;15,4
02.08.20;17:00;44;4;14;76;2036;2174;381;16,6
03.08.20;17:00;44;3;16;70;2045;2178;394;16,2
04.08.20;17:00;45;4;16;84;2045;2194;438;18
05.08.20;17:00;45;5;14;89;2057;2210;448;16,4
06.08.20;17:00;45;4;14;110;2071;2244;474;19,9
07.08.20;22:00;45;2;20;116;2082;2265;541;19,1
08.08.20;22:00;45;2;22;99;2113;2281;519;19,3
09.08.20;22:00;45;3;19;94;2126;2287;530;18,2
10.08.20;22:00;45;5;20;92;2133;2295;534;18,8
11.08.20;22:00;45;5;21;82;2153;2306;524;18
12.08.20;22:00;45;5;20;78;2176;2324;512;18,3
13.08.20;22:00;45;5;24;102;2189;2365;561;19,5
14.08.20;22:00;45;4;24;111;2192;2376;591;17,8
15.08.20;22:00;45;4;24;89;2238;2400;528;19,1
16.08.20;22:00;45;4;20;94;2256;2419;526;21,2
17.08.20;22:00;45;4;20;96;2258;2423;527;20,6
18.08.20;22:00;45;6;24;102;2273;2450;572;23,2
19.08.20;22:00;45;6;24;113;2280;2468;605;23,2
20.08.20;22:00;45;5;20;125;2299;2494;656;20,7
21.08.20;22:00;45;5;18;112;2342;2522;662;23,5
22.08.20;22:00;45;7;14;115;2353;2534;720;21,5
23.08.20;22:00;45;6;16;122;2366;2555;765;21,9
24.08.20;22:00;45;6;13;118;2385;2567;797;23,2
25.08.20;22:00;45;5;15;115;2405;2585;872;21,7
26.08.20;22:00;46;5;14;128;2422;2615;1011;23,6
27.08.20;22:00;46;5;11;120;2454;2636;1053;22,8
28.08.20;22:00;47;5;9;108;2483;2652;1048;20,9
29.08.20;22:00;47;4;9;107;2495;2662;988;20,6
30.08.20;22:00;47;4;8;99;2516;2674;949;19,1
31.08.20;22:00;47;4;7;99;2524;2681;945;18,3
01.09.20;22:00;47;5;7;92;2548;2699;826;18,3
02.09.20;22:00;47;6;7;88;2559;2707;836;14,8
03.09.20;22:00;47;5;7;88;2579;2726;822;14,5
04.09.20;22:00;47;4;9;89;2594;2743;777;14,6
05.09.20;22:00;47;5;7;78;2622;2759;590;15,6
06.09.20;22:00;47;5;7;87;2624;2770;562;15,4
07.09.20;22:00;47;6;7;85;2636;2781;557;16,1
08.09.20;22:00;47;5;9;73;2659;2793;549;15,1
09.09.20;22:00;47;6;12;74;2665;2804;607;15,6
10.09.20;22:00;47;6;11;72;2689;2825;585;15,9
11.09.20;22:00;47;3;10;78;2711;2849;613;17
12.09.20;22:00;47;3;9;79;2720;2858;593;15,9
13.09.20;22:00;47;3;9;80;2730;2869;593;15,9
14.09.20;22:00;47;3;9;75;2749;2883;646;16,4
15.09.20;22:00;47;2;13;83;2756;2901;821;17,4
16.09.20;22:00;47;3;11;86;2778;2925;900;19,5
17.09.20;22:00;47;3;10;102;2782;2944;1021;19,1
18.09.20;22:00;47;2;11;107;2800;2967;1080;19
19.09.20;22:00;47;2;9;111;2816;2985;1040;20,4
20.09.20;22:00;47;2;9;109;2832;2999;1003;20,9
21.09.20;22:00;47;2;10;110;2844;3013;1235;20,9
22.09.20;22:00;47;2;13;109;2860;3031;1328;20,9
23.09.20;22:00;47;2;13;111;2879;3052;1255;20,4
24.09.20;22:00;48;2;12;117;2896;3075;1055;21,1
25.09.20;22:00;48;1;11;123;2920;3103;1290;21,9
26.09.20;22:00;48;2;13;130;2939;3132;1157;23,6
27.09.20;22:00;48;5;14;128;2972;3167;1154;27
28.09.20;22:00;48;3;22;122;2981;3176;1236;26,2
29.09.20;22:00;48;3;21;124;2999;3195;1408;26,4
30.09.20;22:00;48;5;20;135;3013;3221;1497;27,2
01.10.20;22:00;48;3;20;156;3021;3248;1600;27,8
02.10.20;22:00;48;3;20;167;3057;3295;1554;30,9
03.10.20;22:00;48;3;23;166;3076;3316;1346;29,6
04.10.20;22:00;48;4;24;174;3098;3348;1369;29,1
05.10.20;22:00;48;3;21;171;3116;3359;1410;29,4
06.10.20;22:00;49;5;24;161;3159;3398;1400;32,6
07.10.20;22:00;51;6;27;164;3182;3430;1437;33,6
08.10.20;22:00;51;5;30;191;3188;3465;1517;34,9
09.10.20;15:00;52;8;33;221;3257;3571;1723;44,4
10.10.20;22:00;52;9;31;251;3267;3610;1572;47,3
11.10.20;22:00;52;9;33;265;3308;3667;1600;51,3
12.10.20;15:00;52;9;35;270;3347;3713;1680;56,9
13.10.20;22:00;52;9;37;260;3391;3749;1722;56,4
14.10.20;22:00;53;8;32;301;3401;3795;2010;58,7
15.10.20;22:00;53;7;35;330;3476;3901;2050;70,1
16.10.20;22:00;53;8;44;333;3556;3994;2182;68
17.10.20;22:00;53;7;50;295;3672;4077;2064;75,1
18.10.20;22:00;53;7;46;349;3685;4140;2177;76,1
19.10.20;22:00;53;8;53;359;3727;4200;2467;78,3
20.10.20;22:00;54;9;54;396;3763;4276;2617;84,7
21.10.20;22:00;55;10;58;417;3845;4385;2459;94,9
22.10.20;22:00;55;13;61;450;3973;4552;2302;104,7
23.10.20;22:00;55;16;63;350;4202;4686;2356;111,3
24.10.20;22:00;55;16;63;449;4202;4785;2239;113,8
25.10.20;15:00;55;17;62;595;4256;4985;2235;135,9
26.10.20;22:00;55;16;70;711;4291;5143;2675;151,6
27.10.20;22:00;58;19;74;870;4360;5381;3169;177,7
28.10.20;22:00;58;20;90;967;4394;5529;3655;184
29.10.20;22:00;58;20;97;1058;4554;5787;4000;198,6
30.10.20;22:00;60;23;93;1075;4762;6013;4257;213,4
31.10.20;22:00;60;34;102;1038;5007;6241;4193;234,1
01.11.20;22:00;61;28;113;1091;5131;6424;4379;231,4
02.11.20;22:00;61;30;125;1116;5176;6508;4753;219,5
03.11.20;22:00;61;34;121;1113;5379;6708;4782;213,4
04.11.20;22:00;61;32;133;1101;5517;6844;4959;211,5
05.11.20;22:00;61;39;121;1181;5616;7018;5317;197,9
06.11.20;22:00;64;41;121;1117;5831;7174;5486;186,7
07.11.20;22:00;65;41;115;958;6105;7284;5192;167,7
08.11.20;22:00;65;41;118;935;6322;7481;5091;170
09.11.20;22:00;67;41;136;942;6407;7593;5206;174,5
10.11.20;22:00;70;41;138;887;6596;7732;4978;164,7
11.11.20;22:00;70;38;147;958;6696;7909;4870;171,3
12.11.20;22:00;74;31;141;991;6842;8079;4691;170,6
13.11.20;22:00;75;33;136;980;7055;8279;4783;177,7
14.11.20;22:00;75;33;137;893;7303;8441;4160;186
15.11.20;22:00;75;31;145;814;7517;8582;3951;177
16.11.20;22:00;83;36;144;879;7525;8667;4259;172,7
17.11.20;22:00;84;36;156;843;7691;8810;4347;173,3
18.11.20;22:00;87;36;141;906;7829;8999;4568;175,3
19.11.20;22:00;88;32;148;975;7935;9178;4786;176,7
20.11.20;22:00;89;33;145;923;8118;9308;4829;165,5
21.11.20;22:00;89;37;144;834;8311;9415;4329;156,6
22.11.20;22:00;89;39;152;777;8445;9502;4353;147,9
23.11.20;22:00;90;46;163;697;8550;9546;4399;141,3
24.11.20;22:00;91;43;154;643;8707;9638;4559;133,1
25.11.20;22:00;91;46;153;689;8808;9787;4420;126,7
26.11.20;22:00;91;44;137;719;8916;9907;4130;117,2
27.11.20;22:00;94;40;133;686;9093;10046;3744;118,7
28.11.20;22:00;95;44;128;578;9268;10113;3162;112,2
29.11.20;22:00;95;45;139;511;9457;10247;3076;119,8
30.11.20;22:00;95;45;136;534;9486;10296;3122;120,6
01.12.20;22:00;96;47;133;509;9625;10410;3032;124,1
02.12.20;22:00;97;43;120;586;9678;10524;3007;118,5
03.12.20;22:00;97;43;123;628;9731;10622;3029;115
04.12.20;22:00;99;43;120;612;9862;10736;2981;111
05.12.20;22:00;99;47;116;511;10028;10801;2620;110,6
06.12.20;22:00;99;47;123;503;10132;10904;2723;105,6
07.12.20;22:00;105;45;111;515;10156;10932;2745;102,3
08.12.20;22:00;106;47;124;497;10291;11065;2744;105,3
09.12.20;22:00;107;45;123;594;10350;11219;2899;111,8
10.12.20;22:00;107;45;140;610;10459;11361;3041;118,8
11.12.20;22:00;108;40;132;656;10540;11476;3170;119
12.12.20;22:00;108;36;122;640;10660;11566;3056;123
13.12.20;22:00;109;36;131;663;10744;11683;3129;125,3
14.12.20;22:00;111;36;140;649;10792;11728;3192;128
15.12.20;22:00;112;38;153;677;10897;11877;3323;130,6
16.12.20;22:00;115;41;166;800;10933;12055;3579;134,4
17.12.20;22:00;116;42;161;932;10944;12195;3843;134,1
18.12.20;22:00;117;41;166;849;11125;12298;3854;132,2
19.12.20;22:00;117;34;165;760;11293;12369;3623;129,1
20.12.20;22:00;117;35;162;763;11453;12530;3628;136,2
21.12.20;22:00;120;35;176;784;11496;12611;3771;142
22.12.20;22:00;121;36;174;782;11605;12718;3575;135,2
23.12.20;22:00;127;38;166;844;11699;12874;3565;131,7
24.12.20;22:00;127;35;159;919;11728;12968;3523;124,3
25.12.20;22:00;127;38;155;761;11953;13034;3143;118,4
26.12.20;22:00;127;38;152;673;12070;13060;2795;111,1
27.12.20;22:00;127;38;165;581;12236;13147;2673;99,2
28.12.20;22:00;127;39;171;514;12356;13207;2605;95,8
29.12.20;22:00;130;41;178;438;12511;13298;2255;93,3
30.12.20;22:00;131;41;167;478;12587;13404;2131;85,2
31.12.20;22:00;132;41;156;548;12642;13519;2124;88,6
01.01.21;22:00;132;38;147;461;12800;13578;1888;87,5
02.01.21;22:00;132;42;149;328;12981;13632;1597;92
03.01.21;22:00;132;45;154;310;13093;13734;1637;94,4
04.01.21;22:00;135;45;167;343;13093;13783;1738;92,6
05.01.21;22:00;143;37;156;400;13123;13859;1729;90,2
06.01.21;22:00;143;32;140;516;13151;13982;1846;92,9
07.01.21;22:00;146;30;125;568;13218;14087;1868;91,3
08.01.21;22:00;146;31;118;583;13400;14278;1911;112,6
09.01.21;22:00;147;32;122;550;13469;14320;1921;110,6
10.01.21;22:00;147;32;125;503;13621;14428;1825;111,6
11.01.21;22:00;154;33;122;518;13658;14485;1890;112,9
12.01.21;22:00;156;31;122;538;13774;14621;1867;122,5
13.01.21;22:00;157;31;126;480;13913;14707;1756;116,6
14.01.21;22:00;159;35;123;514;13966;14797;1790;114,2
15.01.21;22:00;161;35;117;431;14127;14871;1690;95,4
16.01.21;22:00;161;35;116;377;14264;14953;1671;101,8
17.01.21;22:00;161;36;115;302;14371;14985;1533;89,6
18.01.21;22:00;163;30;118;261;14466;15038;1495;88,9
19.01.21;22:00;167;31;111;209;14602;15120;1304;80,2
20.01.21;22:00;169;27;111;200;14720;15227;1173;83,6
21.01.21;22:00;171;30;109;135;14831;15276;1105;77
22.01.21;22:00;173;30;115;204;14831;15353;1105;77,5
23.01.21;22:00;174;30;109;303;14831;15447;1105;79,4
24.01.21;22:00;174;29;111;337;14831;15482;1105;79,9
25.01.21;22:00;180;30;113;129;15056;15508;928;75,6
26.01.21;22:00;182;22;112;207;15056;15579;928;73,8
27.01.21;22:00;195;25;107;353;15039;15719;1087;79,1
28.01.21;22:00;198;21;116;295;15114;15744;1196;75,3
29.01.21;22:00;204;20;105;308;15204;15841;1253;78,5
30.01.21;22:00;206;19;100;251;15331;15907;1149;74
31.01.21;22:00;206;21;96;259;15357;15939;1062;73,5
01.02.21;22:00;206;21;111;249;15361;15948;1089;70,8
02.02.21;22:00;218;23;106;290;15381;16018;1074;70,6
03.02.21;22:00;221;23;107;338;15391;16080;1102;58,1
04.02.21;22:00;227;24;100;310;15479;16140;1117;63,7
05.02.21;23:59;228;24;100;1144;14700;16196;1126;57,1
06.02.21;23:59;233;24;100;1047;14820;16224;1054;51
07.02.21;23:59;233;24;100;999;14912;16268;1039;52,9
08.02.21;23:59;233;23;91;931;15010;16288;988;54,7
09.02.21;23:59;246;19;78;881;15102;16326;923;49,5
10.02.21;23:59;248;18;69;859;15171;16365;977;45,8
11.02.21;23:59;248;16;67;820;15250;16401;973;42
12.02.21;23:59;252;15;75;750;15338;16430;971;37,6
13.02.21;23:59;252;15;67;723;15408;16465;931;38,8
14.02.21;23:59;252;16;71;683;15470;16492;931;36
15.02.21;23:59;254;17;66;639;15520;16496;930;33,4
16.02.21;23:59;256;17;69;648;15591;16581;983;41
17.02.21;23:59;261;20;72;643;15640;16636;1244;43,6
18.02.21;23:59;263;16;76;620;15703;16678;1347;44,5
19.02.21;23:59;266;20;72;600;15804;16762;1299;53,4
20.02.21;23:59;266;16;76;603;15850;16811;1331;55,6
21.02.21;23:59;266;15;69;617;15890;16857;1317;58,7
22.02.21;23:59;269;19;65;612;15915;16880;1379;61,7
23.02.21;23:59;270;17;66;615;15967;16935;1447;56,9
24.02.21;23:59;273;19;65;611;16016;16984;1501;56
25.02.21;23:59;275;21;64;630;16060;17050;1586;59,8
26.02.21;23:59;276;23;65;572;16166;17102;1610;54,7
27.02.21;23:59;276;23;60;534;16240;17133;1513;51,8
28.02.21;23:59;276;20;59;546;16273;17174;1514;51
